XXXXXXXXXXXXXXXXXXXXXXXXXXXXXXXXXXXXXXXX          
X                                      X          
X                        WW WW         X          
X                       W  W  W        X          
X           FF FF       W     W        X          
X          F  F  F       W   W         X          
X          F     F        W W          X          
X B         F   F          W         G X          
X            F F                       X          
XXXX          F                     XXXX          
XXXXW  X                        X  FXXXX          
XXXXWW                            FFXXXX          
XXXXWWW                          FFXXXXX          
XXXXXWWW  X                  X  FFXXXXXX          
XXXXXXWWW                      FFXXXXXXX          
XXXXXXXWWW                    FFXXXXXXXX          
XXXXXXXXWWW  X            X  FFXXXXXXXXX          
XXWWXWWXXWWW                FFXXFFXFFXXX          
XXWWXWWXXXWWW              FFXXXFFXFFXXX          
XXXXXXXXXXXWWW  X      X  FFXXXXXXXXXXXX          
XXWXXXWXXXXXWWW          FFXXXXXFFFFFXXX          
XXWWWWWXXXXXXWWW        FFXXXXXXFXXXFXXX          
XXXXXXXXXXXXXXWWW      FFXXXXXXXXXXXXXXX          
XXXXXXXXXXXXXXXWW f  w FFXXXXXXXXXXXXXXX          
XXXXXXXXXXXXXXXWWXXXXXXFFXXXXXXXXXXXXXXX          
XXXXXXXXXXXXXXXWWXXXXXXFFXXXXXXXXXXXXXXX          
XXXXXXXXXXXXXXXWWXXXXXXFFXXXXXXXXXXXXXXX          
XXXXXXXXXXXXXXXWWXXXXXXFFXXXXXXXXXXXXXXX          
WWWWWWWWWWWWWWWWWWXXXXFFFFFFFFFFFFFFFFFF          
WWWWWWWWWWWWWWWWWWXXXXFFFFFFFFFFFFFFFFFF          
WWWWWWWWWWWWWWWWWWXXXXFFFFFFFFFFFFFFFFFF          
WWWWWWWWWWWWWWWWWWXXXXFFFFFFFFFFFFFFFFFF          
                                                  
                                                  
                                                  
                                                  
                                                  
                                                  
                                                  
                                                  
                                                  
                                                  
                                                  
                                                  
                                                  
                                                  
                                                  
                                                  
                                                  
                                                  
