XXXXXXXXXXXXXXXXXXXXXXXXXXXXXXXXXXXXXXXX          
X                                      X          
X                                      X          
X                                      X          
X                                    w X          
X  XXXXXXXX                         XXXX          
X                                      X          
X               XXXXX       XXXX       X          
XX                     XXX             X          
X            XXRPPPPPPPPPPPPPPPPPLXX   X          
X            XXXXXXXXXXXXXXXXXXXXXXX   X          
XXXX         XX                        X          
X            XX                        X          
X  f         XX     XRFFFFFFFFFFFFLXXXXX          
X XXXX       XX     XXXXXXXXXXXXXXXXXXXX          
X            XX                        X          
X            XX                        X          
X   XXXXX    XXXXXX                    X          
X                      LXXXXXR         X          
X                                      X          
XPPPPPPPPPXXXXRWWWLXXXRPPPPPPPLXXXX    X          
XXXXXXXXXXXXXXXXXXXXXXXXXXXXXXXXXXX    X          
XXXXXXXXXXX                          XXX          
X                                    XXX          
X    B                               XXX          
X                                    XXX          
XXXXXXXX       RFFFFFFL   RWWWWWWL  XXXX          
X              XXXXXXXX   XXXXXXXX  XXXX          
X    G                              XXXX          
X                                   XXXX          
XXXXXXXXXXXXXXXRWWWWWWLXXXRFFFFFFLXXXXXX          
XXXXXXXXXXXXXXXXXXXXXXXXXXXXXXXXXXXXXXXX          
                                                  
                                                  
                                                  
                                                  
                                                  
                                                  
                                                  
                                                  
                                                  
                                                  
                                                  
                                                  
                                                  
                                                  
                                                  
                                                  
                                                  
                                                  
