XXXXXXXXXXXXXXXXXXXXXXXXXXXXXXXXXXXXXXXX          
X                                      X          
XRPPPPPPPPPPLX           XRPPPPPPPPPPPLX          
XXXXXXXXXXXXX             XXXXXXXXXXXXXX          
X                 XX                   X          
X               XXXXXX                 X          
XRPPPPLX      XXX    XX      XRPPPPPPPLX          
XXXXXXX      XX       XX      XXXXXXXXXX          
X            X         X               X          
X           XX         XX              X          
XRPPPPPLX   X          XX    XRPPPPPPPLX          
XXXXXXXXXX             X    XXXXXXXXXXXX          
X                     XX               X          
X                     X                X          
XRPPPPLX            XXX     XRPPPPPPPPLX          
XXXXXXX             XX    XXXXXXXXXXXXXX          
X                   XXX                X          
X                     X                X          
XRPPPPPPLX            XX    XRPPPPPPPPLX          
XXXXXXXXX              X     XXXXXXXXXXX          
X           X          XX              X          
X           XX         XX              X          
X            X         X    XRPPPPPPPPLX          
X            XX f    wXX  XXXXXXXXXXXXXX          
X             XXX    XX                X          
X               XXXXXX                 X          
X                 XX      XRPPPPPPPPPPLX          
X                       XXXXXXXXXXXXXXXX          
X                                      X          
X  B                                G  X          
X              XRFFFFLX                X          
XXXXXXXXXXXXXXXXXXXXXXXXXXXXXXXXXXXXXXXX          
                                                  
                                                  
                                                  
                                                  
                                                  
                                                  
                                                  
                                                  
                                                  
                                                  
                                                  
                                                  
                                                  
                                                  
                                                  
                                                  
                                                  
                                                  
