XXXXXXXXXXXXXXXXXXXXXXXXXXXXXXXXXXXXXXXX          
X           F                          X          
X           F                          X          
X           F           XXX            X          
X           F                          X          
X           F                          X          
X           F                     X    X          
X           F      XXX       XX   X    X          
X          XXXX      W            X    X          
X                    W    XX      X    X          
X                    W            X    X          
X      XX            W            X    X          
X BG                XXXX          X    X          
X                                 X  f X          
XXXXX                             XXXXXX          
X              XX         XX           X          
X                                      X          
X   XX                                 X          
X                             XXX X    X          
X          XXX                    X    X          
X          W               XX     X    X          
X     XXX  W                      X    X          
X          W        XXX           X    X          
X          W                      X  w X          
X          W     XX               XXXXXX          
X         XXXX        XXXXX            X          
X                                      X          
XPPPPPPPPPPPPPPPPPPPPPPPPPPPPPPPPPPPPPPX          
XPPPPPPPPPPPPPPPPPPPPPPPPPPPPPPPPPPPPPPX          
XPPPPPPPPPPPPPPPPPPPPPPPPPPPPPPPPPPPPPPX          
XPPPPPPPPPPPPPPPPPPPPPPPPPPPPPPPPPPPPPPX          
XXXXXXXXXXXXXXXXXXXXXXXXXXXXXXXXXXXXXXXX          
                                                  
                                                  
                                                  
                                                  
                                                  
                                                  
                                                  
                                                  
                                                  
                                                  
                                                  
                                                  
                                                  
                                                  
                                                  
                                                  
                                                  
                                                  
