XXXXXXXXXXXXXXXXXXXXXXXXXXXXXXXXXXXXXXXX
XX X X X X X X X X   X X X X X X X X X X
X        X                   X         X
X                                      X
X                                      X
X                                      X
X                                   G  X
X w    XRFFFFFLX       XRFFFFFFLX      X
XXXXX  XXXXXXXXX XPPPX XXXXXXXXXX  XXXXX
X               LXXXXXR                X
X              LXXXXXXXR               X
X             LXXXXXXXXXR              X
X   XXX      LXXXXXXXXXXXR     XXXX    X
X           LXXXXXXXXXXXXXR       X    X
X          LXXXXXXXXXXXXXXXR      XRPPLX
X        XXXXXXXXXXXXXXXXXXXXX    XXXXXX
X        X  XXXXXXXXXXXXXXX  X         X
X        X   XXXXXXXXXXXXX   X         X
X    XXXXX    XXXXXXXXXXX    XXXX      X
X              XXXXXXXXX        X      X
X               XXXXXXX         X      X
XXX              XXXXX          X      X
X   XXX           XXX           XXXX   X
X                  X                   X
X                                      X
X                                      X
X B      XXX               XXX         X
X        X                   X       f X
XXXX   XXXRPPPLXRWWWWWLXRPPPLXXXX   XXXX
X        XXXXXXXXXXXXXXXXXXXXX         X
XRPPPPPPLX         X         XRPPPPPPPLX
XXXXXXXXXXXXXXXXXXXXXXXXXXXXXXXXXXXXXXXX
