   WWWWW                                          
WWWW   WWWWWW                                     
W           WWW         WWWWWWWWW                 
W             WWW       W     WWWW                
WW              WW      W     W WWW               
 WW              WW     WWWWWWWWWWW               
  WW              WW  WWWW    WWWW                
   WWW             WWWW WW    WWWW                
     WW      WW     WW   WW  WWWWW                
       WW     WWWWWWWWWWWWW WWW WWW               
         WW WWWWWWWWW      WWWWWW WW              
          WWW    WWWWW     WWWWW   WW             
         WW WWWWWWWWWW    W WWWW    WW            
        WW   WWWWWWWWWWW WW          WW           
        WW WWW  WWWWWW WW     W       W           
         WWW    WWWW            WW    WW          
       WWWWWW                          W          
     WWW             WWWWW                        
   WWW       WWWWWWW                              
  WW                                              
WW                                                
W                           W                     
WWWWWWWWW                                         
                W                     WW          
                                                  
               W            WWW                   
               W    WWW                           
                   WWWW WWWW                      
                            WW                    
                W       W WWW                     
                WW      WWW                       
                 WWWWWWWW                         
                                                  
                                                  
                                                  
                                                  
                                                  
                                                  
                                                  
                                                  
                                                  
                                                  
                                                  
                                                  
                                                  
                                                  
                                                  
                                                  
                                                  
                                                  
