XXXXXXXXXXXXXXXXXXXXXXXXXXXXXXXXXXXXXXXX          
X                                      X          
X                                      X          
X                                      X          
X                                      X          
X     XXXXPXXXPXXXPXXXPXXXPXXXPXXX     X          
X    XXXXXXXXXXXXXXXXXXXXXXXXXXXXXX    X          
X     X                          X     X          
X     X                          X     X          
XX    X                          X    XX          
X     XX                         X     X          
X     X     XXXPXXXPXXXPXXXX     X     X          
X    XX     XXXXXXXXXXXXXXXX     XX    X          
X     X    XX              XX    X     X          
X     X     X              X     X     X          
XX    X     X    XXX       X     X    XX          
X     XX    X     G        X    XX     X          
X     X     X              X     X     X          
X    XX     Xf XRWWWLXX    X     XX    X          
X     X    XXXXXXXXXXX     XX    X     X          
X     X                    X     X     X          
XX    X                   XX     X    XX          
X     XX                  XX    XX     X          
X     XX                  XX     X     X          
X    XXXXXXXPXXXXPXXXPXXXPXX     XX    X          
X     XXXXXXXXXXXXXXXXXXXXXXX    X    BX          
X                                X     X          
XX                               X    XX          
X                               XXw    X          
X                                XX    X          
XRPLXXXXPXXXPXXXPXXXXPXXXXPXXXRPLXXRPPLX          
XXXXXXXXXXXXXXXXXXXXXXXXXXXXXXXXXXXXXXXX          
                                                  
                                                  
                                                  
                                                  
                                                  
                                                  
                                                  
                                                  
                                                  
                                                  
                                                  
                                                  
                                                  
                                                  
                                                  
                                                  
                                                  
                                                  
