XXXXXXXXXXXXXXXXXXXXXXXXXXXXXXXXXXXXXXXX          
XX                                    XX          
XX                                    XX          
X                                      X          
X                                      X          
X                                      X          
Xf                                    wX          
XX                                    XX          
X                                      X          
X   XXX                         XXX    X          
X                                      X          
X                                      X          
X    XRWWLX   XWX     XFX   XRFFLX     X          
X    XXXXXX   XXX     XXX   XXXXXX     X          
X                                      X          
X                                      X          
XRWWWWWLX  XXXX          XXXX  XRFFFFFLX          
XXXXXXXXX                      XXXXXXXXX          
X               XX    XX               X          
X              XXXX  XXXX              X          
X                                      X          
X                                      X          
X                  XX                  X          
X                  XX                  X          
X            XXX  XXXX  XXX            X          
X                                      X          
X       XXX                  XXX       X          
X       X                      X       X          
XG XX   X                      X   XX BX          
X  X    X                      X    X  X          
XXXXRPPLXRPPPPPPPPPPPPPPPPPPPPLXRPPLXXXX          
XXXXXXXXXXXXXXXXXXXXXXXXXXXXXXXXXXXXXXXX          
                                                  
                                                  
                                                  
                                                  
                                                  
                                                  
                                                  
                                                  
                                                  
                                                  
                                                  
                                                  
                                                  
                                                  
                                                  
                                                  
                                                  
                                                  
