XXXXXXXXXXXXXXXXXXXXXXXXXXXXXXXXXXXXXXXX          
X         X        X         X         X          
X         X        X         X         X          
X     X        X        X         X    X          
X f w X        X        X         X    X          
XXXXXXXXXXXXXXXXXXXXXXXXXXXXXXXXXXXXX  X          
X                                      X          
X                                      X          
X                                     XX          
X                                      X          
X                                  XXX X          
X       XX XXX XXX     XXX XXX XXX     X          
X    XRFFFFFFFFFFFFLXXRWWWWWWWWWWWWWWWLX          
X   XXXXXXXXXXXXXXXXXXXXXXXXXXXXXXXXXXXX          
X                                      X          
X                                      X          
X  XXRFFFFFFLX                         X          
X    XXXXXXXX                          X          
XX                                     X          
X                  XXX XXXX XXX        X          
XRWWWWWWWWWWWLXXXRPPPPPPPPPPPPPLX      X          
XXXXXXXXXXXXXXXXXXXXXXXXXXXXXXXXXX     X          
X                                XX    X          
X                                 XX   X          
X                                      X          
X                                      X          
X                 XRFFFLX  XRWWWLXX   XX          
X                  XXXXX    XXXXX      X          
X B G                                  X          
X                                      X          
XXXXXXXXXXXRPPPLXXXRWWWWLXXXRFFFFFFLXXXX          
XXXXXXXXXXXXXXXXXXXXXXXXXXXXXXXXXXXXXXXX          
                                                  
                                                  
                                                  
                                                  
                                                  
                                                  
                                                  
                                                  
                                                  
                                                  
                                                  
                                                  
                                                  
                                                  
                                                  
                                                  
                                                  
                                                  
