XXXXXXXXXXXXXXXXXXXXXXXXXXXXXXXXXXXXXXXX
X                  X                   X
X                  X                   X
X f                X                 w X
XXXX               X                XXXX
X                  X              X    X
X    X X           X                   X
X         X        X          X  X     X
X            X     X       X           X
X              X   X    X              X
X                  X                   X
X                  X                   X
X                 XXXX                 X
X                  XX                  X
X               X  XX  X X             X
X            X     X        X          X
X         X        X           X       X
X      X           X              X    X
X   X              X                X  X
X                  X                   X
X                  X                  XX
XXX                X                   X
XX                 X                   X
XX                 X                 X X
X   X              X              X    X
X      X                       X       X
X         X                 X          X
X     G      X           X      B      X
X               X     X                X
X                                      X
XRWWWWWWWWWWWWWWWLXXXRFFFFFFFFFFFFFFFFLX
XXXXXXXXXXXXXXXXXXXXXXXXXXXXXXXXXXXXXXXX
